## WEST AFRICA ##

Air - Sokoto #capital
Tadmekka - Sokoto
Gao - Songhai #capital
Zarma - Mandingo
Gurma - Mandingo
Djenné - Mandingo
Mali - Mandingo #capital
Bambuk - Mandingo
Timbuktu - Timbuktu #capital
Oualata - Timbuktu
Ghana - Ghana #capital
Aoudaghost - Ghana
Chemana - Wolof
Senegal - Wolof #capital
Gambia - Gambia #capital
Kaabu - Guinea
Guinea - Guinea #capital

Sokoto - fula/gurzil (d_songhay)
Songhai - fula/yoruba (k_songhay)
Mandingo - mandinka/yoruba (k_mandingo)
Timbuktu - fula/mande_pagan (d_timbuktu)
Ghana - berber/gurzil (d_ghana)
Wolof - serer/mande_pagan (d_wolof)
Gambia - afrophoenican/beelshamen (k_gambia)
Guinea - serer/yoruba (d_guinea)


## EAST AFRICA ##

Aswan - Makuria
Makuria - Makuria #capital
Nubia - Nobatia #capital
Aydhab - Kush
Hayya - Kush #capital
Nobatia - Dongola #capital
Bayuda - Dongola
Atbara - Napata #capital
Kassala - Meroe #capital
Sennar - Alodia #capital
Kurdufan - Khordofan #capital
Jebel Uweinat - Darfur
Ouaddai - Darfur
Darfur - Darfur #capital
Nuba - Nuba #capital
Bahr el Ghazal - Azande
Sudd - Azande #capital
Asosa - Abyssinia #capital
Matamma - Abyssinia
Ankober - Shewa #capital
Antalo - Enderta #capital
Semien - D'Mt
Gondar - D'Mt #capital
Medri Bahri - Mangista Aksum
Akordat - Mangista Aksum
Aksum - Mangista Aksum #capital
Afar - Pwenet
Tadjoura - Pwenet #capital
Harer - Harerge #capital
Berbera - Macrobia #capital
Busaso - Alexandria Erythrea #capital
Socotra - Suqotra #capital

Makuria - nubian/monophysite (k_makuria)
Nobatia - nubian/alexandros (k_nobatia)
Kush - nubian/horus_re (e_kush)
Dongola - nubian/aten (d_dongola)
Napata - nubian/amun (d_napata)
Meroe - nubian/horus_re (d_meroe)
Alodia - jewish/jud_zion (k_alodia)
Khordofan - fur/isis (d_khordofan)
Marrah - fur/sol_sahara (d_darfur)
the Nuba - fur/set (k_nuba)
the Azande - zande/zande_pagan (d_azande)
Abyssinia - ethiopian/solomonic_christ (k_abyssinia)
Shewa - ethiopian/jud_ark (d_shewa)
Enderta - ethiopian/solomonic_alexandros (k_enderta)
D'Mt - sabaean/maher (k_eritrea)
Mangista Aksum - ethiopian/sol_tsahay (k_aksum)
Pwenet - sabaean/talab (d_punt)
Harerge - afrophoenician/beelshamen (d_harer)
Macrobia - sabaean/attar (k_macrobia)
Alexandria Erythrea - indohellenic/indoh_hindu (d_busaso)
Suqotra - sabaean/allat (d_socotra)


## NEW RELIGIONS ##

amun - Amunite (Archaic/Mainstream/Statist) - Unreformed
aten - Atenist (Archaic/Heretical/Martial) - Unreformed
amun_horus - Ra-Horakhtic (Archaic/Local /Messianic) - Unreformed
isis - Isetite (Archaic/Local/Clerical) - Unreformed
set - Sūtaḫi (Archaic/Heretical/Messianic (Apocalyptic)/Barbarian) - Unreformed
jud_zion - Khawdash Siyunic (Jewish/Local/Populist) - Reformed
jud_ark - ʾĀrôn Habbərîtan (Jewish/Local/Traditional/Gnostic) - Unreformed
solomonic_alexandros - Solomon-Alexandrian (Christian/Local/Martial/Graeco-Roman) - Reformed
yoruba - Yoruba (Barbarian/Local/Clerical/Gnostic) - Reformed
zande_pagan - Mbori (Barbarian/Local/Martial) - Unreformed
sol_sahara - Renatus Solisean (Barbarian/Local/Messianic/Graeco-Roman) - Unreformed

amun_reformed
	amun
	amun-horus
aten_reformed
	aten
set_reformed
	set
isis_reformed
	isis
jud_zion
jud_ark_reformed
	jud_ark
solomonic_alexandros
yoruba
zande_pagan_reformed
	zande_pagan
sol_sahara_reformed
	sol_sahara


## NEW CULTURES ##

fula - Fulbe
serer - Soninke
mandinka - Mandinka
zande - Zande
fur - Fur
afrophoenician - Annôné