Made k_venice de jure and moved d_venice, d_carinthia, and d_verona under it
Made k_pisa de jure and moved d_pisa and d_toscana under it
Moved d_syria from k_syria to k_mesopotamia
Moved c_negev from d_oultrejordain to d_ascalon
Moved c_bremen from d_holstein to d_brunswick
Moved d_kabylia from k_africa to k_numidia
Moved d_alger from k_mauretania to k_numidia
Made d_mahra de jure (under k_saba) and moved c_duqm, c_dhofar, and c_mahra under it
Made d_nordmark de jure (under k_frisia) and moved c_oldenburg and c_osnabruck under it
Moved c_weimar from d_saxony to d_thuringia
Removed d_oultrejourdain and added all counties to d_arabia_felix

Culture changes:
Kufa - Badawi to Ashuri
Hijaz - Ashuri to Badawi
Samarra - Ashuri to Kurd
Oromieh - Pârsa to Kurd
Kermanshah - Kurd to Pârsa

Religious changes:
Foix - Catholic to Cathar
Piemonte - Solar-Christian to Catholic
Chud - Suomenuskan to Voipel'ean
Pskov - Forn Sidr to Odinn-Solar
Sudovia - Perkunan to Dievasic
Galich Mersky - Voipel'ean to Odinn-Solar
Turkmen - Mazdakist to Nestorian
Merv - Nestorian to Mazdakist
Narke - Scandinist to Ford Sidr
Kasogs - Orthodox to Arian
Guines - Catholic to Pelagian
Oleshye - Tengri-Manichaean to Manichaean
Ragusa - Bogomilist to Orthodox
Al Sukhnah - Malakbêlite to Druze

Furor Africanus:
Nubia - Monophysite to Alexandros-Amonite
Kathiri - Tal'abi to Almaqahi
Aden - Al-Lati to Almaqahi
Busaso - sabaean > indohellenic | 'Attari to Indo-Hellenic Hindu
Tadjoura - Maherite to Tal'abi
Kassala - ethiopian > nubian | Ts'ahay Mahremite to Amunite
Hayya - Monophysite to Ra-Horakhty
Atbara - ethiopian > nubian | Ts'ahay Mahremite to Amunite
Sennar - ethiopian > jewish | Ts'ahay Mahremite to Khawdash Siyunic
Ankober - Solomonic Christian to 'Aron Habritan
Gondar - Solomonic Christian to Ts'ahay Mahremite
Antalo - Solomonic Christian to Solomon-Alexandrian